+-------------------------------------------------------------------------+
|                                                                         |
|                                                                         |
|    +----------------+         +          +        +----------------+    |
|    |                |         |          |        |                |    |
|    |                |         |          |        |                |    |
|    +----------------+         |          |        +----------------+    |
|                               |          |                              |
|                               |          |                              |
+-------+                       |          |                              |
|       |         +-------------+          +--------------+     +---+     |
+-------+                           +--+                        |   |     |
|P                                  |  |                        |   |     |
+-------+                           +--+                        |   |     |
|       |         +------------+           +--------------+     +---+     |
+-------+                      |           |                              |
|                              |           |                              |
|                              |           |                              |
|    +----------------+        |     E     |        +----------------+    |
|    |                |        |           |        |                |    |
|    |                |        |           |        |                |    |
|    +----------------+        +           +        +----------------+    |
|                                                                         |
|                                                                         |
+-------------------------------------------------------------------------+
